#######################################
***************************************
***************************************
***************************************
***********************################
***************************************
***************************************
***************************************
***************************************
***************************************
***************************************
***************************************
***************************************
***************************************
***************************************
***************************************
***************************************
***************************************
***************************************
##########*****************************
***************************************
***************************************
***************************************
***************************************
***************************************
***************************************
***************************************
***************************************
***************************************
#######################################